{
  "map": {
    "rows": 11,
    "columns": 13,
    "layout": [
      ["U", "U", "U", "U", "U", "U", "U", "U", "U", "U", "U", "U", "U"],
      ["U", " ", " ", "D", "R", "R", "D", "R", "R", "D", " ", " ", "U"],
      ["U", " ", "U", "D", "U", "D", "U", "D", "U", "D", "U", " ", "U"],
      ["U", "D", "R", "R", "D", "D", "D", "R", "D", "D", "D", "D", "U"],
      ["U", "R", "U", "R", "R", "R", "R", "R", "R", "D", "U", "D", "U"],
      ["U", "R", "R", "R", "D", "R", "R", "R", "D", "R", "D", "D", "U"],
      ["U", "R", "U", "R", "R", "D", "R", "D", "U", "R", "U", "D", "U"],
      ["U", "D", "R", "R", "D", "D", "D", "D", "R", "R", "D", "D", "U"],
      ["U", " ", "U", "D", "U", "R", "U", "R", "U", "D", "U", " ", "U"],
      ["U", " ", " ", "D", "R", "R", "R", "R", "R", "D", " ", " ", "U"],
      ["U", "U", "U", "U", "U", "U", "U", "U", "U", "U", "U", "U", "U"]
    ]
  }
}