{
  "rows": 11,
  "columns": 17,
  "layout": [
    [" ", "U", "U", "U", "U", "U", "U", "U", " ", "U", "U", "U", "U", "U", "U", "U", " "],
    ["U", "U", "P", "F", "R", "R", "R", "U", "U", "U", "R", "R", "R", "F", "P", "U", "U"],
    ["U", "R", "F", "U", "R", "R", "R", "R", "R", "R", "R", "R", "R", "U", "F", "R", "U"],
    ["U", "R", "U", "R", "R", "R", "R", "R", "R", "R", "R", "R", "R", "R", "U", "R", "U"],
    ["U", "R", "R", "R", "R", "R", "U", "R", "R", "R", "U", "R", "R", "R", "R", "R", "U"],
    ["U", "R", "R", "R", "R", "R", "R", "R", "U", "R", "R", "R", "R", "R", "R", "R", "U"],
    ["U", "R", "R", "R", "R", "R", "U", "R", "R", "R", "U", "R", "R", "R", "R", "R", "U"],
    ["U", "R", "U", "R", "R", "R", "R", "R", "R", "R", "R", "R", "R", "R", "U", "R", "U"],
    ["U", "R", "F", "U", "R", "R", "R", "R", "R", "R", "R", "R", "R", "U", "F", "R", "U"],
    ["U", "U", "P", "F", "R", "R", "R", "U", "U", "U", "R", "R", "R", "F", "P", "U", "U"],
    [" ", "U", "U", "U", "U", "U", "U", "U", " ", "U", "U", "U", "U", "U", "U", "U", " "]
  ]
}