{
  "rows": 11,
  "columns": 17,
  "layout": [
    ["U", "U", "U", "U", "U", "U", "U", "U", " ", "U", "U", "U", "U", "U", "U", "U", "U"],
    ["U", "R", "R", "R", "U", "R", "R", "U", "U", "U", "R", "R", "U", "R", "F", "P", "U"],
    ["U", "R", "R", "R", "R", "U", "R", "R", "R", "R", "R", "U", "R", "R", "R", "F", "U"],
    ["U", "R", "R", "R", "R", "R", "R", "R", "R", "R", "R", "R", "R", "R", "R", "R", "U"],
    ["U", "U", "R", "R", "R", "R", "U", "R", "R", "R", "U", "R", "R", "R", "R", "U", "U"],
    [" ", "U", "U", "R", "R", "R", "R", "R", "U", "R", "R", "R", "R", "R", "U", "U", " "],
    ["U", "U", "R", "R", "R", "R", "U", "R", "R", "R", "U", "R", "R", "R", "R", "U", "U"],
    ["U", "R", "R", "R", "R", "R", "R", "R", "R", "R", "R", "R", "R", "R", "R", "R", "U"],
    ["U", "F", "R", "R", "R", "U", "R", "R", "R", "R", "R", "U", "R", "R", "R", "R", "U"],
    ["U", "P", "F", "R", "U", "R", "R", "U", "U", "U", "R", "R", "U", "R", "R", "R", "U"],
    ["U", "U", "U", "U", "U", "U", "U", "U", " ", "U", "U", "U", "U", "U", "U", "U", "U"]
  ]
}