{
  "rows": 11,
  "columns": 13,
  "layout": [
    ["U", "U", "U", "U", "U", "U", "U", "U", "U", "U", "U", "U", "U"],
    ["U", "P", "F", "D", "R", "R", "D", "R", "R", "D", "F", "F", "U"],
    ["U", "F", "U", "D", "U", "D", "U", "D", "U", "D", "U", "F", "U"],
    ["U", "D", "R", "R", "D", "D", "D", "R", "D", "D", "D", "D", "U"],
    ["U", "R", "U", "R", "R", "R", "R", "R", "R", "D", "U", "D", "U"],
    ["U", "R", "R", "R", "D", "R", "R", "R", "D", "R", "D", "D", "U"],
    ["U", "R", "U", "R", "R", "D", "R", "D", "U", "R", "U", "D", "U"],
    ["U", "D", "R", "R", "D", "D", "D", "D", "R", "R", "D", "D", "U"],
    ["U", "F", "U", "D", "U", "R", "U", "R", "U", "D", "U", "F", "U"],
    ["U", "F", "F", "D", "R", "R", "R", "R", "R", "D", "F", "P", "U"],
    ["U", "U", "U", "U", "U", "U", "U", "U", "U", "U", "U", "U", "U"]
  ]
}